111111111111111111111111111111
1E0000000000000C1100C000000001
101001010010000011100100000011
111001001010101000100100000001
1P1000000C00C00000000000000001
111111111111111111111111111111