111111111111111111111111111111
1E0000000000000011000100000101
111001001010101000100100000001
1P00000C000C0000C0C00000000001
111001001010101000100100000001
111001001010101000100100000001
111001001010101000100100000001
100000000000000011000100000101
100000000000000011000100000101
111001001010101000100100000001
111001001010101000100100000001
111001001010101000100100000001
100000000000000011000100000101
100000000000000011000100000101
111001001010101000100100000001
111001001010101000100100000001
111001001010101000100100000001
100000000000000011000100000101
100000000000000011000100000101
111001001010101000100100000001
111001001010101000100100000001
111001001010101000100100000001
100000000000000011000100000101
100000000000000011000100000101
111001001010101000100100000001
111001001010101000100100000001
111001001010101000100100000001
100000000000000011000100000101
100000000000000011000100000101
111111111111111111111111111111
