111111111111
1PC000E00001
100000000001
100000000001
111111111111