111111111111
1P0C0C0C0E01
110001000101
111111111111