111111111111
100CCCCC0E01
1100CPC00101
1000CCC01011
111111111111