111111111111
1P0000100001
11000C000001
100000000001
111111111111