1111111111
1P1CC11E11
1100011111
1111111111